111111111111111111111111111111111111111111111111111111111111111111111111111111111111111111111111111111111111111111111111111111111111111111
111111111111111111111111111111111111111111111111111111111111111111111111111111111111111111111111111111111111111111111111111111111111111111
111111111111111111111111111111111111111111111111111111111111111111111111111111111111111111111111111111111111111111111111111111111111111111
111111111111111111111111111111111111111111111111111111111111111111111111111111111111111111111111111111111111111111111111111111111111111111
111111111111111111111111111111111111111111111111111111111111111111111111111111111111111111111111111111111111111111111111111111111111111111
111111111111111111111111111111111111111111111111111111111111111111111111111111111111111111111111111111111111111111111111111111111111111111
111111111111111111111111111111111111111111111111111111111111111111111111111111111111111111111111111111111111111111111111111111111111111111
111111111111111111111111111111111111111111111111111111111111111111111111111111111111111111111111111111111111111111111111111111111111111111
111111111111111111111111111111111111111111111111111110000001111111111111111111111111111111111111111111111111111111111111111111111111111111
111111111111111111111111111111111111111111111111111100000000011111111111111111111111111111111111111111111111111111111111111111111111111111
111111111111111111111111111111111111111111111111111000000000001111110111111111111111111111111111111111111111111111111111111111111111111111
111111111111111111111111111111111111111111111111100000000000001111110011111111111111111111111111111111111111111111111100001111111111111111
111111111111111111111111111111111111111111111110000000000000000111110001111111111111111111111111111111111111111111111000000111111111111111
111111111111111111111111111111111111111111111100000000000000000001100000001111111111111111111111111111111111111111110000000011111111111111
111111111111111111111111111111111111111111111100000000000000000000000000000011111111111111111111111111111111111111100000000001111111111111
111111111111111111111111111111111111111111111100000000000000000000000000000000011111111111111111111111111111111111000000000000000011111111
111111111111111111111100011100011111111111111100000000000000000000000000000000001111111111111111111111111111111111000000000000000001111111
111111111111111111111000000000001111111111111110000000000000000000000000000000000011111111111111111111111111111111000001110000000001111111
111111111111111111111000000000001111111111111111000000000000000000011000000000000001111100111111111111111111111111000111111000000001111111
111111111111111111110000000000011111111111111111100000000000000000111100000000000000111000011111111111111111111110000011111110000011111111
111111111111111111000000000011111111111111111111100000000000001111111100000000000000000000011111111111111111111100000111111111111111111111
111111111111111110000000000111111111111111111111100000000000011111111110000000000000000000001100111111111111111100000111111111111111111111
111111111111111000000000000111111111111111111111110000000000011111111110000000000000000000000000000011111111111000001111111111111111111111
111111111111110000000000000011111111111111111111111000000000011111111111000000000000000000000000000001111111111000001111111111111111111111
111111111111110000000000000000011000001111111111111100000000011111111111100000000000000000000000000001111111110000011111111111111111111111
111111111111111000000000000000000000000111111111111110000000001111111111111000000000000000000000000000111111110000011111111111111111111111
111111111111111100000000000000000000000111111111111111000000000011111111111100000000000000000000000000011111100000111111111111111111111111
111111111111111110000000000000000000000011111111111111100000000001111111111100000000000000000000000000001111100000111111111111111111111111
111111111111111110000000000000000000000000000011110011110000000001111111111100000000000000000000000000001111000001111111111111111111111111
111111111111111100000000000000000000000000000001100001111000000000111111111110000000000000000000000000011111000011111111111111111111111111
111111111111111100000000000000000000000000000000000001111000000000011111111111110000000000000000000000011110000001111111111111111111111111
111111111111111100000000000000000000000000000000000001111000000000001111100111111000000000000000000000011110000000011111111111111111111111
111111111111111000000000000000000000000000000000000000111000000000001111000011111000000000000000000000001110000000001111111111111111111111
111111111111110000000000000000000000000000000000000000011000000000001111000000010000000000000000000000001110000000000111111111111111111111
111111111111110000000000000000000000000000000000000000000000000000011111100000000000000000000000000000001110000000000111111111111111111111
111111111111111000000000000000000000000000000000000000000000000011111111100000000000000000000000000000011110000000001111110000111111111111
111111111111111111000000000000000111000000000000000000000000000111111111100000000000000000000000000001111110000000111111100000011111111111
111111111111111111100000000000001111100001110000000000000000000111111111110000000000000000000000000011111111000001111111000000000111111111
111111111111111111100000000000011111111111111000000000000000000011111111111000000000000000000000000011111111000001111100000000000001111111
111111111111111111110000000000011111111111111100111000000000000000111111111100000011110000000000000001111110000000110000000000000000111111
111111111111111111111000000000001111111111111111111100000000000000111111111111111111111000000000000000000000000000000000000000000000111111
111111111111111111111100000000000011111111111111111110000000000000111111111111111111111000000000000000000000110000000000000000000000111111
111111111111111111111111110000000001111111111111111110000000001111111111111111111111111000000000000000000001111000000000000000000000111111
111111111111111111111111111000000001111111111111111111001111111111111111111111111111111000000000000000000001111000000000000000000000111111
111111111111111111111111111000000000111111111111111111111111111111111111111111111111111100011000000000000001111000000000000000000000111111
111111111111111111111001110000000000111111111111111111111111111111111111111111111111111111111100000000000000111100000000000000000000111111
111111111111111111110000000000000000111111111111111111111111111111111111111111111111111111111111110000000000111110000000000000000000111111
111111111111111000110000000000000000011001111111111111111111111111111111111111111111111111111111111000000001111111000000000000000000111111
111111111111110000011000000000000000000000111111111111111111111111111111111111111111111111111111111100000001111111000000000000000000111111
111111111111100000011111100000000000000000000111111111111111111111111111111111111111111100111111001110000001111111100000000000000000111111
111111111111100000001111110000000000000000000011111111111111111111111111111111111111111000000110000111000011111111110000000000000000111111
111111111111000000000111100000000000000000000011111111111111111111111111111111111111111000000000000011111111111111111000000000000000111111
111111111110000000000000000000000000000000000001111111111111111111111100111111111111111000000000000011111111111111111111000000000000111111
111111111100000000000000000000000001110000000000111111111111111111111000000111111100110000000000000011111111111111111111100000000000111111
111111111000000000000000000000000011111000000000001111111111111111111000000011111000000011000000000011111111111111111111100000000001111111
111111111000000000000000000000000111110000000000000111111111111111111100000011111000000111100000000001110001111111111111110000000001111111
111111111100000000000000000000001111100000000000000011111111111111111100000111111100000111100000000000000000000000001111110000000011111111
111111111110000000000000000000001111000000000000000111111111111100111000001111111110000111100000000000000000000000000111110000001111111111
111111111111000000000000000000000111000000000000011111111111111000000000001111111111000011100000000000000000000000000011100000011111111111
111111111111100000000000000000000011100000000000111111111111111000000000001111111111000001110000000000000000000000000000000000011111111111
111111111111100000000000000000000011110000000000111111111111111100000000000111111111000001111000000000000000000000001100000000001111111111
111111111111110000000000000000000011110000000000011111111111111100000000000000001110000001111111000000000000000000011110000000000111111111
111111111111111111110000000011000111110000000000001111111111111100000000000000000000000001111111100000001111111000111111110000000011111111
111111111111111111111100000111111111110000000000000111111111111000000000000000000000000011111111100000011111111111111111111110000001111111
111111111111111111111111001111111111100000000000000001111111110000000110000000000000001111111111000000011111111111111111111111000001111111
111111111111111111111111111111111111100000000000000000111111110000001111000000000000011111111111000000111111111111111111111111100001111111
111111111111111111111111111111111111110000001111000000111111111000011111100011000000011111111111100001111111111111111111111111110011111111
111111111111111111111111111111111111111111111111111001111111111111111111111111110000111111111111111111111111111111111111111111111111111111
111111111111111111111111111111111111111111111111111111111111111111111111111111111111111111111111111111111111111111111111111111111111111111
111111111111111111111111111111111111111111111111111111111111111111111111111111111111111111111111111111111111111111111111111111111111111111
111111111111111111111111111111111111111111111111111111111111111111111111111111111111111111111111111111111111111111111111111111111111111111
111111111111111111111111111111111111111111111111111111111111111111111111111111111111111111111111111111111111111111111111111111111111111111
111111111111111111111111111111111111111111111111111111111111111111111111111111111111111111111111111111111111111111111111111111111111111111
111111111111111111111111111111111111111111111111111111111111111111111111111111111111111111111111111111111111111111111111111111111111111111
